BBBBBBBBBBBBBBBBBB
BBBBBMMMMMTTTTTTBB
BBBBMMMMMMMTTTTBBB
BMMMMMMMMMMMMTTMMM
BMMMMMMGGGGMMMMMMM
BMMMMMGGGMMMMMMMMM
BMMMMGGGGGMMMMMMMM
BMMMMMMMMMMMMTMMMM
BMMMMMMMMMMTTTTMMM
BMMMMMMMMMMTTTTMMM
BVVVVVVMMMMMMTTMMM
BMMMMMVVVMMMMMMMMM
BMMMMMMMVMMMMMMMMM
BVVVVVVVVGGMMMMMMM
BVVVVVVVVVGGGMMMMM
BVVVVVVVVVVVVMMMMM
BVVVVVVVVVVVMMMMMM
BVVVVVVVVVVMMMMMMM