VVVVVVVMMMMMMMMMMMMMMMMMMMMMMMMMMMMMMMMMMMMMMMMMMMMMMMMMMMMMMMMMMMMMMMMMMMMBBBBBBBBBBBBBBBBBBBBBBBBB
VVVVVVVVMMMMMMMMMMMMMMMMMMMMMMMMMMMMMMMMMMMMMMMMMMMMMMMMMMMMMMMMMMMMMMMMMMMBBBBBBBBBBBBBBBBBBBBBBBBB
VVVVVVVVVMMMMMMMMMMMMMMMMMMMMMMMMMMMMMMMMMMMMMMMMMMMMMMMMMMMMMMMMMMMMMMMMMMBBBBBBBBBBBBBBBBBBBBBBBBB
MMMVVVVVVVMMMMMMMMMMMMMMMMMMMMMMMMMMMMMMMMMMMMMMMMMMMMMMMMMMMMMMMMMMMMMMMMMBBBBBBBBBBBBBBBBBBBBBBBBB
MMMMMVVVVVVMMMMMMMMMMMMMMMMMMMMMMMMMMMMMMMMMMMMMMMMMMMMMMMMMMMMMMMMMMMMMMMMMBBBBBBBBBBBBBBBBBBBBBBBB
MMMMMMVVVVVVMMMMMMMMMMMMMMMMMMMMBBMMMMMMMMMMMMMMMMMMMMMMMMMMMMMMMMMMMMMMMMMMMBBBBBBBBBBBBBBBBBBBBBBB
MMMMMMMVVVVVMMMMMMMMMMMMMMMMMMMBBBBMMMMMMMMMMMMMMMMMMMMMMMMMMMMMMMMMMMMMMMMMMBBBBBBBBBBBBBBBBBBBBBBB
MMMMMMMMVVVVVMMMMMMMMMMMMMMMMMMBBBBMMMMMMMMMMMMMMMMMMMMMMMMMMMMMMMMMMMMMMMMMMMBBBBBBBBBBBBBBBBBBBBBB
MMMMMMMMVVVVVMMMMMMMMMMMMMMMMMMMBBMMMMMMMMMMMMMMMMTTMMMMMMMMMMMMMMMMMMMMMMMMMMMBBBBBBBBBBBBBBBBBBBBB
MMMMMMMMMVVVVMMMMMMMMMMMMMMMMMMMMMMMMMMMMMMMMMMMMTTTTMMMMMMMMMMMMMMMMMMMMMMMMMMMBBBBBBBBBBBBBBBBBBBB
MMMMMMMMMVVVVVMMMMMMMMMMMMMMMMMMMMMMMMMMMMMMMMMMMTTTTMMMMMMMMMMMMMMMMMMMMMMMMMMMBBBBBBBBBBBBBBBBBBBB
MMMMMMMMMVVVVVMMMMMMMMMMMMMMMMMMMMMMMMMMMMMMMMMMMMTTMMMMMMMMMMMMMMMMMMMMMMMMMMMMMBBBBBBBBBBBBBBBBBBB
MMMMMMMMMMVVVVMMMMMMMMMMMMMMMMMMMMMMMMMMMMMMMMMMMMMMMMMMMMMMMMMMMMMMMMMMMMMMMMMMMMBBBBBBBBBBBBBBBBBB
MMMMMMMMMMVVVVMMMMMMMMMMMMMMMMMMMMMMMMMMMMMMMMGGGGMMMMMMMMMMMMMMMMMMMMMMMMMMMMMMMMMBBBBBBBBBBBBBBBBB
MMMMMMMMMMVVVVMMMMMMMMMMMMMMMMMMMMMMMMMMMMMGGGGGGGGMMMMMMMMMMMMMMMMMMMMMMMMMMMMMMMMMBBBBBBBBBBBBBBBB
MMMMMMMMMMVVVVMMMMMMMMMMMMMMMMMMTTTMMMMMMMGGGGGGGGGMMMMMMMMMMMMMMMMMMMMMMMMMMMMMMMMMMBBBBBBBBBBBBBBB
BMMMMMMMMMVVVVMMMMMMMMMMMMMMMTTTTTTTTMMMMMGGGGGGGGGMMMMMMMMMMMMMMMMMMMMMMMMMMMMMMMMMMMMBBBBBBBBBBBBB
BBMMMMMMMMVVVVMMMMMMMMMMMMMMTTTTTTTTTTMMMMGGGGGGGGGMMMMMMMMMMMMMMMMMMMMMMMMMMMMMMMMMMMMMMBBBBBBBBBBB
BBBMMMMMMMVVVVMMMMMMMMMMMMMMTTTTTTTTTTTMMMGGGGGGGGGMMMMMMMMMMMMMMMMMMMMMMMMMMMMMMMMMMMMMMMMMBBBBBBBM
BBBMMMMMMMVVVVMMMMMMMMMMMMMTTTTTTTTTTTTTMMMGGGGGGGGMMMMMMMMMMMMMMMMMMMMMMMMMMMMMMMMMMMMMMMMMMMMMMMMM
BBBMMMMMMMVVVVMMMMMMMMMMMMMTTTTTTTTTTTTTMMMMGGGGGGMMMMMMMMMMMTTTTMMMMMMMMMMMMMMMMMMMMMMMMMMMMMMMMMMM
BBBMMMMMMMVVVVVMMMMMMMMMMMMTTTTTTTTTTTTTMMMMMGGGGMMMMMMMMMMMTTTTTTMMMMMMMMMMMMMMMMMMMMMMMMMMMMMMMMMM
BBBMMMMMMMVVVVVMMMMMMMMMMMMTTTTTTTTTTTTTMMMMMMMMMMMMMMMMMMMMTTTTTTMMMMMMMMMMMMMMMMMMMMMMMMMMMMMMMMMM
BBBMMMMMMMMVVVVMMMMMMMMMMMMTTTTTTTTTTTTTMMMMMMMMMMMMMMMMMMMMMTTTTMMMMMMMMMMGGGGMMMMMMMMMMMMMMMMMMMMM
BBBMMMMMMMMVVVVMMMMMMMMMMMMMTTTTTTTTTTTTMMMMMMMMMMMMMMMMMMMMMMTTMMMMMMMGGGGGGGGGMMMMMMMMMMMMMMMMMMMM
BBBMMMMMMMMVVVVMMMMMMMMMMMMMMTTTTTTTTTTTMMMMMMMMMMMMMMMMMMMMMMMMMMMMMMGGGGGGGGGGGMMMMMMMMMMMMMMMMMMM
BBBMMMMMMMMVVVVMMMMMMMMMMMMMMMTTTTTTTTTMMMMMMMMMMMMMMMMMMMMMMMMMMMMMMMGGGGGGGGGGGMMMMMMMMMMMMMMMMMMM
BBBMMMMMMMMVVVVMMMMMMMMMMMMMMMMTTTMMMMMMMMMMMMMMMMMMMMMMMMMMMMMMMMMMMMGGGGGGGGGGGMMMMMMMMMMMMMMMMMMM
BBBMMMMMMMMVVVVVMMMMMMMMMMMMMMMMMMMMMMMMMMMMMMMMMMMMMMMMMMMMMMMMMMMMMMGGGGGGGGGGMMMMMMMMMMMMMMMMMMMM
BBBMMMMMMMMVVVVVMMMMMMMMMMMMMMMMMMMMMMMMMMMMMMMMMMMMMMMMMMMMMMMMMMMMMMMGGGGGGGGGMMMMMMMMMMMMMMMMMMMM
BBBBMMMMMMMMVVVVMMMMMMMMMMMMMMMMMMMMMMMMMMMMMMMMMMMMMMMMMMMMMMMMMMMMMMMMGGGGGGGMMMMMMMMMMMMMMMMMMMMM
BBBBMMMMMMMMVVVVMMMMMMMMMMMMMMMMMMMMMMMMMMMMMMMMMMMMMMMMMMMMMMMMMMMMMMMMMGGGGMMMMMMMMMMMMMMMMMMMMMMM
BBBBMMMMMMMMVVVVMMMMMMMMMMMMMMMMMMMMMMMMMMMTTMMMMMMMMMMMMMMMMMMMMMMMMMMMMMMMMMMMMMMMMMMMMMMMMMMMMMMM
BBBBMMMMMMMMVVVVVMMMMMMMMMMMMMMMMMMMMMMMMMTTTTMMMMMMMMMMMMMMMMMMMMMMMMMMMMMMMMMMMMMMMMMMMMMMMMMMMMMM
BBBBMMMMMMMMMVVVVMMMMMMMMMMMMMMMMMMMMMMMMMTTTTMMMMMMMMMMMMMMMMMMMMMMMMMMMMMMMMMMMMMMMMMMMMMMMMMMMMMM
BBBBMMMMMMMMMVVVVVMMMMMMMMMMMMMMMMMMMMMMMMMTTMMMMMMMMMMMMMMMMMMMMMMMMMMMMMMMMMMMMMMMMMMMMMMMMMMMMMMM
BBBBMMMMMMMMMMVVVVMMMMMMMMMMMMMMMMMMMMMMMMMMMMMMMMMMMMMMMMMMMMMMMMMMMMMMMMMMMMMMMMMMMMMMMMMMMMMMMMMM
BBBBBMMMMMMMMMVVVVMMMMMMMMMMMMMMMMMMMMMMMMMMMMMMMMMMMMMMTTTMMMMMMMMMMMMMMBBBBBBMMMMMMMMMMMMMMMMMMMMM
BBBBBMMMMMMMMMVVVVVMMMMMMMMMMMMMMMMMMMMMMMMMMMMMMMMMMMMTTTTTMMMMMMMMMMMMBBBBBBBBMMMMMMMMMMMMMMMMMMMM
BBBBBMMMMMMMMMMVVVVMMMMMMMMMMMMMMMMMMMMMMMMMMMMMMMMMMMMTTTTTMMMMMMMMMMMMBBBBBBBBMMMMMMMMMMMMMMMMMMMM
BBBBBMMMMMMMMMMVVVVMMMMMMMMMMMMMMMMMMMMMMMMMMMMMMMMMMMMTTTTTMMMMMMMMMMMMBBBBBBBBMMMMMMMMMMMMMMMMMMMM
BBBBBMMMMMMMMMMVVVVVMMMMMMMMMMMMMMMMMMMMMMMMMMMMMMMMMMMMTTTMMMMMMMMMMMMMBBBBBBBBMMMMMMMMMMMMMMMMMMMM
BBBBBMMMMMMMMMMMVVVVVMMMMMMMMMMMMMMMMMMMMMMMMMMMMMMMMMMMMMMMMMMMMMMMMMMMMBBBBBBBMMMMMMMMMMMMMMMMMMMM
BBBBBMMMMMMMMMMMMVVVVMMMMMMMMMMMMMMMMMMMMMMMMMMMMMMMMMMMMMMMMMMMMMMMMMMMMMBBBBBMMMMMMMMMMMMMMMMMMMMM
BBBBBMMMMMMMMMMMMVVVVVMMMMMMMMMMMMMMMMMMMMMMMMMMMMMMMMMMMMMMMMMMMMMMMMMMMMMMMMMMMMMMMMMMMMMTTTTMMMMM
BBBBBBMMMMMMMMMMMVVVVVMMMMMMMMMMMMMMMMMMMMMMMMMMMMMMMMMMMMMMMMMMMMMMMMMMMMMMMMMMMMMMMMMMMMTTTTTTMMMM
BBBBBBMMMMMMMMMMMMVVVVVMMMMMMMMMMMMMMMMMMMMMMMMMMMMMMMMMMMMMMMMMMMMMMMMMMMMMMMMMMMMMMMMMMMTTTTTTMMMM
BBBBBBMMMMMMMMMMMMMVVVVVMMMMMMMMMMMMMMMMMMMMMMMMMMMMMMMMMMMMMMMMMMMMMMMMMMMMMMMMMMMMMMMMMTTTTTTTMMMM
BBBBBBMMMMMMMMMMMMMVVVVVVMMMMMMMMMMMMMMMMMMMMMMMMMMMMMMMMMMMMMMMMMMMMMMMMMMMMMMMMMMMMMMMMTTTTTTTTMMM
BBBBBBMMMMMMMMMMMMMMVVVVVVVMMMMMMMMMMMMMMMMMMMMMMMMMMMMMMMMMMMMMMMMMMMMMMMMMMMMMMMMMMMMMMMTTTTTTTMMM
BBBBBBMMMMMMMMMMMMMMMVVVVVVVVMMMMMMMMMMMMMMMMMMMMMMMMMMMMMMMMMMMMMMMMMMMMMMMMMMMMMMMMMMMMMTTTTTTTMMM
BBBBBBMMMMMMMMMMMMMMMMVVVVVVVVVVVVVMMMMMMMMMMMMMMMMMMMMMMGGGGGGMMMMMMMMMMMMMMMMMMMMMMMMMMMTTTTTTTMMM
BBBBBBMMMMMMMMMMMMMMMMMVVVVVVVVVVVVVVVVVVMMMMMMMMMMMMMMMGGGGGGGGMMMMMMMMMMMMMMMMMMMMMMMMMMMTTTTTTMMM
BBBBBBBMMMMMMMMMMMMMMMMMMVVVVVVVVVVVVVVVVVVVVVVMMMMMMMMGGGGGGGGGMMMMMMMMMMMMMMMMMMMMMMMMMMMTTTTTTMMM
BBBBBBBMMMMMMMMMMMMMMMMMMMMMVVVVVVVVVVVVVVVVVVVVVVVMMMMGGGGGGGGGMMMMMMMMMMMMMMMMMMMMMMMMMMMMTTTTMMMM
BBBBBBBMMMMMMMMMMMMMMMMMMMMMMMMMMVVVVVVVVVVVVVVVVVVVVMGGGGGGGGGGMMMMMMMMMMMMMMMMMMMMMMMMMMMMMMMMMMMM
BBBBBBBMMMMMMMMMMMMMMMMMMMMMMMMMMMMMMMMMVVVVVVVVVVVVVGGGGGGGGGGMMMMMMMMMMMMMMMMMMMMMMMMMMMMMMMMMMMMM
BBBBBBBMMMMMMMTTTMMMMMMMMMMMMMMMMMMMMMMMMMMMMMVVVVVVGGGGGGGGGMMMMMMMMMMMMMMMMMMMMMMMMMMMMMMMMMMMMMMM
BBBBBBBMMMMMMTTTTTMMMMMMMMMMMMMMMMMMMMMMMMMMMMMMMMVVGGGGGGGGVVVMMMMMMMMMMMMMMMMMMMMMMMMMMMMMMMMMMMMM
BBBBBBBMMMMMTTTTTTMMMMMMMMMMMMMMMMMMMMMMMMMMMMMMMMMGGGGGGGGGVVVVVMMMMMMMMMMMMMMMMMMMMMMMMMMMMMMMMMMM
BBBBBBBMMMMMTTTTTMMMMMMMMMMMMMMMMMMMMMMMMMMMMMMMMMMGGGGGGGGVVVVVVVVVMMMMMMMMMMMMMMMMMMMMMMMMMMMMMMMM
BBBBBBBMMMMMTTTTMMMMMMMMMMMMMMMMMMMMMMMMMMMMMMMMMMGGGGGGGGGGVVVVVVVVVVMMMMMMMMMMMMMMMMMMMMMMMMMMMMMM
BBBBBBBMMMMMMTTMMMMMMMMMMMMMMMMMMMMMMMMMMMMMMMMMMMGGGGGGGGGGMMVVVVVVVVVVVMMMMMMMMMMMMMMMMMMMMMMMMMMM
BBBBBBBMMMMMMMMMMMMMMMMMMMMMMMMMMMMMMMMMMMMMMMMMMGGGGGGGGGGMMMMMVVVVVVVVVVVMMMMMMMMMMMMMMMMMMMMMMMMM
BBBBBBBMMMMMMMMMMMMMMMMMMMMMMMMMMMMMMMMMMMMMMMMMMGGGGGGGGMMMMMMMMMMVVVVVVVVVMMMMMMMMMMMMMMMMMMMMMMMM
BBBBBBBMMMMMMMMMMMMMMMMMMMMMMMMMMMMMMMMMMMMMMMMMMGGGGGGGGMMMMMMMMMMMMVVVVVVVVVMMMMMMMMMMMMMMMMMMMMMM
BBBBBBBMMMMMMMMMMMMMMMMMMMMMMMMMMMMMMMMMMMMMMMMMGGGGGGGGMMMMMMMMMMMMMMMMVVVVVVVVMMMMMMMMMMMMMMMMMMMM
BBBBBBBMMMMMMMMMMMMMMMMMMMMMMMMMMMMMMTTMMMMMMMMMGGGGGGGGMMMMMMMMMMMMMMMMMMVVVVVVVVMMMMMMMMMMMMMMMMMM
BBBBBBBMMMMMMMMMMMMMMMMMMMMMMMMMMMMMTTTTTTMMMMMMGGGGGGGMMMMMMMMMMMMMMMMMMMMVVVVVVVVVMMMMMMMMMMMMMMMM
BBBBBBBMMMMMMMMMMMMMMMMMMMMMMMMMMMMMTTTTTTTMMMMMGGGGGGMMMMMMMMMMMMMMMMMMMMMMMVVVVVVVVMMMMMMMMMMMMMMM
BBBBBBBMMMMMMMMMMMMMMMMMMMMMGGGGMMMMMTTTTTTTTMMMMGGMMMMMMMMMMMMMMMMMMMMMMMMMMMMVVVVVVVVMMMMMMMMMMMMM
BBBBBBBBMMMMMMMMMMMMMMMMMMMGGGGGGMMMMMTTTTTTTTMMMMMMMMMMMMMMMMMMMMMMMMMMMMMMMMMMMVVVVVVVMMMMMMMMMMMM
BBBBBBBBBMMMMMMMMMMMMMMMMMMGGGGGGGGGGMMMTTTTTTMMMMMMMMMMMMMMMMMMMMMMMMMMMMMMMMMMMMVVVVVVVMMMMMMMMMMM
BBBBBBBBBBMMMMMMMMMMMMMMMMMGGGGGGGGGGGMMMMTTTMMMMMMMMMMMMMMMMMMMMMMMMMMMMMMMMMMMMMMMVVVVVVVMMMMMMMMM
BBBBBBBBBBMMMMMMMMMMMMMMMMMGGGGGGGGGGGMMMMMMMMMMMMMMMMMMMMMMMMMMMMMMMMMMMMMMMMMMMMMMMMVVVVVVMMMMMMMM
BBBBBBBBBBMMMMMMMMMMMMMMMMMGGGGGGGGGGMMMMMMMMMMMMMMMMMMMMMMMMMMMMMMMMMMMMMMMMMMMMMMMMMMVVVVVVVVVMMMM
BBBBBBBBBBMMMMMMMMMMMMMMMMMMGGGGGGMMMMMMMMMMMMMMMMMMMMMMMMMMMTTTTMMMMMMMMMMMMMMMMMMMMMMMVVVVVVVVVMMM
BBBBBBBBBBMMMMMMMMMMMMMMMMMMMMGGGMMMMMMMMMMMMMMMMMMMMMMMMMMMTTTTTTMMMMMMMMMMMMMMMMMMMMMVVVVVVVVVVVMM
BBBBBBBBBBBMMMMMMMMMMMMMMMMMMMMMMMMMMMMMMMMMMMMMMMMMMMMMMMMTTTTTTTTMMMMMMMMMMMMMMMMMMMMVVVVVVVVVVVVM
BBBBBBBBBBBMMMMMMMMMMMMMMMMMMMMMMMMMMMMMMMMMMMMMMMMMMMMMMMTTTTTTTTTMMMMMMMMMMMMMMMMMMMVVVVVVVVVVVVVV
BBBBBBBBBBBMMMMMMMMMMMMMMMMMMMMMMMMMMMMMMMMMMMMMMMMMMMMMMMTTTTTTTTMMMMMMMMMMMMMMMMMMMMVVVVVVVVVVVVVV
BBBBBBBBBBBBMMMMMMMMMMMMMMMMMMMMMMMMMMMMMMMMMMMMMMMMMMMMMMTTTTTTTMMMMMMMMMMMMMMMMMMMMMVVVVVVVVVVVVVV
BBBBBBBBBBBBBBMMMMMMMMMMMMMMMMMMMMMMMMMMMMMMMMMMMMMMMMMMMMTTTTMMMMMMMMMMMMMMMMMMMMMMMVVVVVVVVVVVVVVV
BBBBBBBBBBBBBBBBMMMMMMMMMMMMMMMMMMMMMMMMMMMMMMMMMMMMMMMMMMMTTMMMMMMMMMMMMMMMMMMMMMMMVVVVVVVVVVVVVVVV
BBBBBBBBBBBBBBBBBMMMMMMMMMMMMMMMMMMMMMMMMMMMMMMMMMMMMMMMMMMMMMMMMMMMMMMMMMMMMMMMMMMMVVVVVVVVVVVVVVVV
BBBBBBBBBBBBBBBBBBMMMMMMMMMMMMMMMMMMMMMMMMMMMMMMMMMMMMMMMMMMMMMMMMMMMMMMMMMMMMMMMMMMVVVVVVVVVVVVVVVV
BBBBBBBBBBBBBBBBBBBMMMMMMMMMMMMMMMMMMMMMMMMTTTTTTMMMMMMMMMMMMMMMMMMMMMMMMMMMMMMMMMMMVVVVVVVVVVVVVVVV
BBBBBBBBBBBBBBBBBBBMMMMMMMMMMMMMMMMMMMMMMMTTTTTTTTMMMMMMMMMMMMMMMMMMMMMMMMMMMMMMMMMMVVVVVVVVVVVVVVVV
BBBBBBBBBBBBBBBBBBBBMMMMMMMMMMMMMMMMMMMMMTTTTTTTTTTTTTTMMMMMMMMMMMMMMMMMMMMMMMMMMMMMVVVVVVVVVVVVVVVV
BBBBBBBBBBBBBBBBBBBBMMMMMMMMMMMMMMMMMMMMTTTTTTTTTTTTTTTTMMMMMMMMMMMMMMMMMMMMMMMMMMMMVVVVVVVVVVVVVVVV
BBBBBBBBBBBBBBBBBBBBBMMMMMMMMMMMMMMMMMMTTTTTTTTTTTTTTTTTMMMMMMMMMMMMMMMMMMMMMMMMMMMMVVVVVVVVVVVVVVVV
BBBBBBBBBBBBBBBBBBBBBBBMMMMMMMMMMMMMMMMTTTTTTTTTTTTTTTTTTMMMMMMMMMMMMMMMMMMMMMMMMMMMVVVVVVVVVVVVVVVV
BBBBBBBBBBBBBBBBBBBBBBBBMMMMMMMMMMMMMMTTTTTTTTTTTTTTTTTTTMMMMMMMMMMMMMMMMMMMMMMMMMMMMVVVVVVVVVVVVVVV
BBBBBBBBBBBBBBBBBBBBBBBBBMMMMMMMMMMMMMTTTTTTTTTTTTTTTTTTTMMMMMMMMMMMMMMMMMMMMMMMMMMMMVVVVVVVVVVVVVVV
BBBBBBBBBBBBBBBBBBBBBBBBBMMMMMMMMMMMMMTTTTTTTTTTTTTTTTTTMMMMMMMMMMMMMMMMMMMMMMMMMMMMMVVVVVVVVVVVVVVV
BBBBBBBBBBBBBBBBBBBBBBBBBBMMMMMMMMMMMMTTTTTTTTTTTTTMTTTMMMMMMMMMMMMMMMMMMMMMMMMMMMMMMVVVVVVVVVVVVVVV
BBBBBBBBBBBBBBBBBBBBBBBBBBMMMMMMMMMMMMMTTTTMMMMMMMMMMMMMMMMMMMMMMMMMMMMMMMMMMMMMMMMMMMVVVVVVVVVVVVVV
BBBBBBBBBBBBBBBBBBBBBBBBBBMMMMMMMMMMMMMMMMMMMMMMMMMMMMMMMMMMMMMMMMMMMMMMMMMMMMMMMMMMMMVVVVVVVVVVVVVV
BBBBBBBBBBBBBBBBBBBBBBBBBBMMMMMMMMMMMMMMMMMMMMMMMMMMMMMMMMMMMMMMMMMMMMMMMMMMMMMMMMMMMMVVVVVVVVVVVVVV
BBBBBBBBBBBBBBBBBBBBBBBBBBMMMMMMMMMMMMMMMMMMMMMMMMMMMMMMMMMMMMMMMMMMMMMMMMMMMMMMMMMMMMMVVVVVVVVVVVVV
